X 24 Y 11
X 25 Y 11
X 26 Y 11
X 27 Y 11
X 28 Y 11
X 29 Y 11
X 30 Y 11
X 31 Y 11
X 32 Y 11
X 33 Y 11
X 34 Y 11
X 35 Y 11
X 36 Y 11
