000r0000%Dg:(J~#*10000000000000000000000
0j500-7W0C0Br005c10000000000000000000000
0$00r0$0006000o}010000000000000000000000
00000j0000j0$000010000000000000000000000
@00B000000000000010000000000000000000000
1111000000000000010000000000000000000000
1111000000000000010000000000000000000000
1111111000000000010000000000000000000000
1111111110000000010000000000000000000000
111111111000000X010000000000000000000000
1111111111111111110000000000000000000000
0000000000000000000000000000000000000000
0000000000000000000000000000000000000000
0000000000000000000000000000000000000000
0000000000000000000000000000000000000000
0000000000000000000000000000000000000000
0000000000000000000000000000000000000000
0000000000000000000000000000000000000000
0000000000000000000000000000000000000000
0000000000000000000000000000000000000000
0000000000000000000000000000000000000000
0000000000000000000000000000000000000000
0000000000000000000000000000000000000000
0000000000000000000000000000000000000000
0000000000000000000000000000000000000000
0000000000000000000000000000000000000000
0000000000000000000000000000000000000000
0000000000000000000000000000000000000000
0000000000000000000000000000000000000000
0000000000000000000000000000000000000000
0000000000000000000000000000000000000000
0000000000000000000000000000000000000000
ANONYMOUS
CAVE
4
4
4
NONE
2


0