0000000000000000000000000000000000000000
0000000000000000000000000000000000000000
0000000000000000000000000000000000000000
0000000000000000000000000000000000000000
0000000000000000000000000000000000000000
0000000000000011110000000000000000000000
0X00000000110011110001000000000000000000
111P111111111111110000000000000000000000
000L000000000000010001000000000000000000
000L000000000000010000000000000000000000
000L0000000000000111111111111111P1111111
000L0000000000000000000000000000L0000000
000L0000000000000000000000000000L0000000
000L0000000000000000000000000000L0000000
000L0000000000000000000000000000L0000000
000L0000000000000000000000000000L0000000
000L0000000000000000000000000000L0000000
000L0000000000000000000000000000L0000000
000L0000000000000000000000000000L0000000
1111111110000111000111001110111111111111
0000000000000000000000000000000000000000
0000000000000000000000000000000000000000
0000000000000000000000000000000000000000
0000000000000000000000000000000000000000
0000000000000000000000000000000000000000
0000000000000000000000000000000000000000
0000000000000000000000000000000000000000
0000000000000000000000000000000000000000
0000000000000000000000000000000000000000
0000000000000000000000000000000000000000
0000000000000000000000000000000000000000
0000000000000000000000000000000000000000
ANONYMOUS
CAVE
4
4
4
NONE
1

0