0000000000000000000011100000000000000000
0000000000000000000011100000000000000000
00000*0000*00000000011100000000000000000
00000111P1100000000011100000000000000000
00000000L0000000000011100000000000000000
00000000L0000000000011100000000000000000
00000000L0000000000011100000000000000000
0000000111110000000011100000000000000000
0000000111111000000011100000000000000000
0@00111111111100X00011100000000000000000
1111111111111111111111100000000000000000
1111111111111111111111100000000000000000
0000000000000000000000000000000000000000
0000000000000000000000000000000000000000
0000000000000000000000000000000000000000
0000000000000000000000000000000000000000
0000000000000000000000000000000000000000
0000000000000000000000000000000000000000
0000000000000000000000000000000000000000
0000000000000000000000000000000000000000
0000000000000000000000000000000000000000
0000000000000000000000000000000000000000
0000000000000000000000000000000000000000
0000000000000000000000000000000000000000
0000000000000000000000000000000000000000
0000000000000000000000000000000000000000
0000000000000000000000000000000000000000
0000000000000000000000000000000000000000
0000000000000000000000000000000000000000
0000000000000000000000000000000000000000
0000000000000000000000000000000000000000
0000000000000000000000000000000000000000
ANONYMOUS
CAVE
4
4
4
NONE
2


0