100L0b100L001000000000000000000000000000
100L00100L001000000000000000000000000000
111P11111P111000000000000000000000000000
100L00100LT01000000000000000000000000000
100L0A100L001000000000000000000000000000
111P11111P111000000000000000000000000000
100L00100L001000000000000000000000000000
100L0z100L0a1000000000000000000000000000
111P11111P111000000000000000000000000000
100L00100L001000000000000000000000000000
100L0F100L001000000000000000000000000000
111P11111P111000000000000000000000000000
100L00100L001000000000000000000000000000
100L0f100L001000000000000000000000000000
111P11111P111000000000000000000000000000
100L00100L001000000000000000000000000000
1H0L0h100L001000000000000000000000000000
111P11111P111000000000000000000000000000
100L00100L1+1000000000000000000000000000
1y0L1K100L001000000000000000000000000000
111P11111P111000000000000000000000000000
100LS01[0L0]1000000000000000000000000000
100L001]0L0[1000000000000000000000000000
111P11111P111000000000000000000000000000
100L0s100L001000000000000000000000000000
1M0L0010<L>01000000000000000000000000000
111P11111P111000000000000000000000000000
100L00100L001000000000000000000000000000
1m0L0n1^0L0^1000000000000000000000000000
111P11111P111000000000000000000000000000
100L00000L000000000000000000000000000000
1@0L00000L000000000000000000000000000X00
ANONYMOUS
CAVE
4
4
4
NONE
2


0